.........................
.........................
......#############......
......#c#pbccbck#c#......
......#ccc#ccc#ccc#......
......#ccc###cc#c##......
......#kc#cc#cc#b##......
......#cssc#kvc#cc#......
......#c#ccccc#c#c#......
......#c#c##vccccc#......
......#c#c#ccc#b#c#......
......#ckccccccccc#......
......#############......
.........................
.........................
